15 15
110 77 2 25 4 5 6 0 1 2 3 4 5 6 110
77 2 3 4 33 6 0 1 2 3 4 5 6 0 1
2 3 4 5 6 33 1 77 3 4 5 6 0 1 2
3 4 5 6 25 1 2 110 4 5 6 0 1 2 3
9 110 6 0 1 2 77 4 5 6 110 1 2 3 77
5 6 0 1 2 3 4 5 6 0 1 2 33 4 25
6 0 1 2 25 4 5 6 0 1 2 3 4 33 6
110 1 2 3 4 5 6 0 1 2 3 4 5 6 77
1 2 3 4 5 6 0 1 2 3 4 5 6 0 1
25 3 4 5 6 33 1 110 110 4 5 6 0 1 2
33 4 5 6 0 1 2 110 110 5 9 0 1 2 3
110 110 6 0 1 2 3 4 5 6 0 1 44 44 44
110 6 0 1 2 3 4 5 6 0 1 2 44 44 44
110 0 25 2 3 4 5 6 0 1 2 3 44 44 44
110 77 77 110 4 5 6 0 33 2 3 33 44 44 44