15 15
110 77 2 44 4 5 6 0 1 2 3 4 5 6 110
77 2 3 4 33 6 0 1 2 3 4 5 6 0 1
2 3 4 5 6 33 1 77 3 4 5 6 0 1 2
3 4 5 6 44 1 2 110 4 5 6 0 1 2 3
9 110 6 0 1 2 77 4 5 6 110 1 2 3 77
5 6 0 1 2 3 4 5 6 0 1 2 33 4 44
6 0 1 2 44 4 5 6 0 1 2 3 4 33 6
110 1 2 3 4 5 6 0 1 2 3 4 5 6 77
1 2 3 4 5 6 0 1 2 3 4 5 6 0 1
44 3 4 5 6 33 1 110 110 4 5 6 0 1 2
33 4 5 6 0 1 2 110 110 5 9 0 1 2 3
110 110 6 0 1 2 3 4 5 6 0 1 2 3 77
110 6 0 1 2 3 4 5 6 0 1 2 3 4 44
110 0 44 2 3 4 5 6 0 1 2 3 4 5 6
110 77 77 110 4 5 6 0 33 2 3 33 5 6 110